11 70
#.##################################################################.#
......................................................................
#...#####.......#####..............#####........#####................#
#...#?......#...#...#..............#...#........#.?.#.........#......#
#...#####.......#.?.#.####..####...#.?.#..#####.#####.####...........#
....#.......#...#...#.#..?#.#..##..#...#..#.?.#.#.....#..##...#.......
#...#.......#...#####.#...#.###?#..#####..#####.#.....###?#...#......#
#.........................................#..........................#
#.........................................#..........................#
......................................................................
#.##################################################################.#
4
3 5 4 18
4 37 5 25
6 31 5 44
6 57 3 50
4
1 1
1 68
9 1
9 68
